 XXXXXXXXXXXX
X        XX X
XXXX XXXXXX X
X  X XX     X
XXXX XXX XX X
X        XX X
XXXXXXXX XX X
X            
XXXXXXXXXXX D